10-px
-p---pp---
---p------
----------
-----p----
----p--p--
--------p-
-----p-p--
---p-----p
-p----p---
-p--------
