20-px
----------p----p----
-p------p--------pp-
p-------pp---p--p---
--p--p-------p----pp
----p----p----p-----
-----------pp-ppp-pp
----------p---------
------------p-pp--pp
----------p----p----
-----p------p-p--p--
-p--p-p----p-p------
--p------p--p-------
--p---p-------------
---p------p-p---pp--
----pp--p---p-------
----p-------p-----p-
----------p---p-----
p------p-p--p-p-p--p
-p---p------p-------
pp-------p---p--p--p
