10-px
------p--p----p--pp-
-----ppp-p---p------
--pp-pp--ppp----p---
--p-p-pp------p--p--
-----------p---p----
--p-pp------p-------
p---p----p---p-p--p-
-----p-p-------p-p--
p--p--p-------pp-p--
-pp--pp---p-p---p---
